App|五子棋游戏|1	AppType|游戏|1	add	app.bin
App|拼图游戏|1	AppType|小游戏|1	add	app.bin
App|斗地主游戏|1	AppType|小游戏|1	add	app.bin
App|空当接龙游戏|1	AppType|小游戏|1	add	app.bin
App|纸牌|1	AppType|小游戏|1	add	app.bin
App|纸牌游戏|1	AppType|小游戏|1	add	app.bin
App|象棋游戏|1	AppType|小游戏|1	add	app.bin
App|音乐|1	AppType|音乐|1	add	app.bin
App|pptv聚力|1	AppType|视频|1	add	app.bin
App|qq音乐|1	AppType|音乐|1	add	app.bin
App|优酷|1	AppType|视频|1	add	app.bin
App|导航|1	AppType|地图|1	add	app.bin
App|地图|1	AppType|地图|1	add	app.bin
App|导航|1	AppType|地图|1	add	app.bin
App|导航地图|1	AppType|地图|1	add	app.bin
App|高德导航|1	AppType|地图|1	add	app.bin
App|凯立德导航|1	AppType|地图|1	add	app.bin
App|百度地图|1	AppType|地图|1	add	app.bin
App|导航犬|1	AppType|地图|1	add	app.bin
App|安徽旅游|1	AppType|旅游|1	add	app.bin
